111111111111111111
133333333333333331
133355555550000031
133555555555555531
133555555511115531
133555555555555531
121115555555000031
111433333333333331
111111111111111111
