111111111111111111
143000000000300051
111111111111111151
100300000030003051
101111111111111151
130000030000030031
111111111111111131
120000030000000031
111111111111111111
