111111111111111111
100000033300000001
100030011100000001
100055053500000001
100011032300000001
100000113110000001
105500001555000031
101100004333331131
111111111111111111
