111111111111111111
133333331413333331
133333331013333331
133333331313333331
133333331013333331
133333331013333331
133333331013333331
133333330203333331
111111111111111111
