111111111111111111
130000003000000051
141111111111111131
111300033300005131
125311111111113131
131130051115113131
131111131113113331
100030000000003331
111111111111111111
