111111111111111111
102100030000000031
100100000000000111
100101111111500001
100100401113300001
100103001000100001
150111110011110001
130000000013003001
111111111111111111
