111111111111111111
100500000000010001
130100011110003001
101100031111011001
130333331035001001
131111111011111501
111000033313333331
120011111113313331
141110000011111111
