000000000000000000
011111111111111110
010000003000033310
013300005000111110
013330052500000010
010001110111003010
015550000555555510
013333000333333410
011111111111111110
