111111111111111111
100000000110000001
100033333333500001
100011111111100001
101113333333105551
153053332333133331
153013333333133331
155011111111133341
111111111111111111
