111111111111111111
133333113111333341
131111133311311111
133333113111313311
111113113111311311
133333113311333311
115111111511151111
102000000300030011
111111111111111111
