111111111111111111
133333335453333331
133333335553333331
133333333333333331
133333333333333331
111001103330000111
100000003330000001
105000205530000001
111111111111111111