111111111111111111
121313140550000351
131313100335555331
131313100111111111
131313100003333001
131310100333333331
101510111111111101
103330000000030001
111111111111111111
