111111111111111000
121000000000001111
101515550005550001
101315553033330401
101313311111111111
101313300003333331
101311100050533531
100500000335355531
111111111111111111
