111111111111111111
131550000001140001
133330000050005031
111110000555001111
100000035555500001
150000355255555551
135001111011115551
133300500000005551
111111111111111111
